OOOOOOOOOOOOOOOOO
& O      O      O
O O   OO O OOOO O
O OOO O  O    O O
O O   O  OOOO O O
O O OOO  O    O O
O O O    O  O O O
O O O  OOO  O O O
O   O  O   OO O O
OOOOO  O  O   O O
O      O  O OOOOO
O  OOOOO  O O   O
O  O      O O O O
O  O OOOOOO O O O
O  O O  OOO   O O
O    O        O U
OOOOOOOOOOOOOOOOO