O&O      O     
O O   OO O OOOO
O OOO O  O    O
O O   O  OOOO O
O O OOO  O    O
O O O    O  O O
O O O  OOO  O O
O   O  O   OO O
OOOOO  O  O   O
O      O  O OOO
O  OOOOO  O O U
O  O      O O O
O  O OOOOOO O O
O  O O  OOO   O
O    O        O